-18
20
-11
12
11111111111111111111111111111111111111
10000000000000000000000000000000000001
10000000000000000000000000000000000001
10000000000000000000000000000000000001
10000000000000000000000000000000000001
10000000000000000000000000000000000001
10000000000000000000000000000000000001
10000000000000000000000000000000000001
10000000000000000000000000000000000001
10000000000111111100000000000000000001
10000000000111111100000000000000000001
10000000000111111100000000000000000001
10000000000111111100000000000000000001
10000000000111111100000000000000000001
10000000000111111100000000000000000001
10000000000111111100000000000000000001
10000000000000000000000000000000000001
10000000000000000000000000000000000001
10000000000000000000000000000000000001
10000000000000000000000000000000000001
10000000000000000000000000000000000001
10000000000000000000000000000000000001
11111111111111111111111111111111111111
